
 #############     ###
 #   #    ####     # #
 ######    # #     # #
 #   #     ######### #
 #   #             # #
 #                 # #
 #                 # #
 #        ##       # #
 #        ##       # #
 #        ########## #
 ###############   # #
 #         #       # #
 #     #   #       # #
 #     #####       # #
 #      #  #       # #
 ########  #########
 #             ###########
 $                  #
