                 
 # #    ### ##   
 ####     #  ## #
 ##  # ### ### ##
  # ##     ### ##
      ##### #    
   # # ##   # #  
 ##     ##  #### 
 ###  ## # ## #  
 ## ## #  # # # #
  # ########   # 
 ## ###    # ## #
  #  ####    ## #
 # #   #   #  #  
 # #    ##$#     
 ## # #  # # #   
 ###    # ###  # 
