                 
 ## ########     
 #$ #### #  #####
   # #####  ## ##
 # ##     # ### #
  # # #  ##    ##
 ### #       ## #
   #   ## # #    
  # # $#   ##  # 
 ## #    # #  #  
 ## # # ## # ##  
 ##      #   #   
 ##  ## # ## ### 
 ##   ##    # # #
 #    ## # #   ##
  # #   ##  # ###
 ## # ##  # # #  
